
000000000000000000000000000000000000000000000000000000
000000000000000000000000000000000000000000000000000000
000100100000100100000000001000100000000001000010100000
000100100110100100011000001000100110010101000010100000
000111101010100100100100001000101001011001000110100000
000100101100100100100100001010101001010001001010000000
000100100110110110011000000101000110010001100110100000
000000000000000000000000000000000000000000000000000000
000000000000000000000000000000000000000000000000000000
